-------------------------------------------
OOOOOxOOOOOOxOOOxOOOOOOxOOOOOOOOOxOOOOOOOO-
OOOOOxOOOOOOxOOOxOOOOOOxOOxOOOOOOxOOOOOOOO-
OOOOOOOOxOOOOOOOxOOOOOOOOOxOOOxOOxOOOOOOOO-
OOOOOOOOxOOOOOOOxOOOOOOxOOxOOOxOOOOOOOxOOO-
OOOOOxOOOOOOxOOOOOOOOOOxOOOOOOxOOOOOOOxOOO-
OOOOOxOOOOOOxOOOOOOOOOOxOOOOOOxOOOOOOOxOOO-
-------------------------------------------