------------------------------------------------------------------------
OOOOOxOOOOOOxOOOxOOOOOOxOOOOOOOOOxOOOOOOOOOOOOOxOOOOOOxOxOxxxOxOOOOOOOO-
OOOOOOOOOOOOxOOOxOOOOOOxOOxOOOOOOxOOOOOOOOxOOOxxOOOOOOxOxOxxxOOOOOOOOOO-
OOOOOOOOxOOOOOOOxOOOOOOOOOxOOOxOOxOOOOOOOOxOOOxxOOOOOOxOOOOxxOOOOOOOOOO-
OOOOOOOOxOOOOOOOxOOOOOOxOOxOOOxOOOOOOOxOOOxOOOOOOOOOxOOOOxOOOOOOOOOOOOO-
OOOOOOOOOOOOxOOOOOOOOOOxOOOOOOxOOOOOOOxOOOxOOxOOxOOOxOOOOxxxOOOOOOOOOOO-
OOOOOxOOOOOOxOOOOOOOOOOxOOOOOOxOOOOOOOxOOOxOOxxxxOOOxOOOOxxxOOOOOOOOOOO-
------------------------------------------------------------------------